Heure,Balance avant,Balance apr√®s,Profit,Action
2023-01-16 23:38:53,199.33,198.97,-0.36,"Close short position for symbol FX:EURUSD at price 1.08235 for 4000 shares. Position AVG Price was 1.082260, currency: USD, point value: 1.000000"
2023-01-16 22:32:18,192.67,199.33,+6.66,"Close long position for symbol FX_IDC:EURUSD at price 1.08248 for 6000 shares. Position AVG Price was 1.081370, currency: USD, point value: 1.000000"
2023-01-16 18:44:08,194.11,192.67,-1.44,"Close long position for symbol FX_IDC:EURUSD at price 1.08120 for 3000 shares. Position AVG Price was 1.081680, currency: USD, point value: 1.000000"
2023-01-16 18:37:06,194.56,194.11,-0.45,"Close long position for symbol FX_IDC:EURUSD at price 1.08150 for 3000 shares. Position AVG Price was 1.081650, currency: USD, point value: 1.000000"
2023-01-16 18:35:25,195.28,194.56,-0.72,"Close long position for symbol FX_IDC:EURUSD at price 1.08150 for 2000 shares. Position AVG Price was 1.081860, currency: USD, point value: 1.000000"
2023-01-16 18:23:02,195.00,195.28,+0.28,"Close short position for symbol FX_IDC:EURUSD at price 1.08228 for 2000 shares. Position AVG Price was 1.082420, currency: USD, point value: 1.000000"
2023-01-16 09:34:40,194.94,195.00,+0.06,"Close short position for symbol FX_IDC:EURUSD at price 1.08091 for 2000 shares. Position AVG Price was 1.080940, currency: USD, point value: 1.000000"